111111111111111111111111
1P0000100000000000000001
100000100000000100000001
100000100000000100000001
100000100C0C000100000001
1000001000C0001000000001
100000010C0C010000000001
100000001111100000000E01
100000100000000000000001
111111111111111111111111